abadi	věčný
abo	kabát, plášť
abr	mrak
abrešim	hedvábí
abru	obočí
adabiyot	literatura
adad	číslo, číslice
adadi butun	celé číslo
adadi juft	sudé číslo
adadi toq	liché číslo
adolat	spravedlnost, právo
afkandan	vrhnout, hodit, odpálit
afkor	názor, mínění, úsudek
afruxtan	zapálit
afsar	voják
afsus	bohužel, naneštěstí
afšondan	třást, otřásat, třepat
afšurdan	vymačkat
aft	tlama, huba
aftida	padlý, spadlý
aftidan	padat, spadnout
aftiš	pád, dopad
afvi	amnestie
afzaliyat	výhoda
afzaliyatnok	výhodný
afzoiš	zvýšení, přirážka
afzudan	zvýšit, zvětšit, stoupat
agar	jestli
ahamiyat	význam, důležitost
ahdnoma	dohoda, úmluva
aholi	obyvatelstvo, populace
ajib	divný, zvláštní
ajina	čarodějnice
ajoib	divný, zvláštní, zajímavý
aka	bratr
aknun	teď, nyní
aksar	většina
aksariyat	většina
alaf	tráva
alayhi	proti
albatta	zajisté, ovšem
allakay	již, už
alohida	oddělený
aloka	pouto, svazek
aloma	znamení
alomat	znak, značka, znaménko
alomati suol	otazník
alomati xitob	vykřičník
aloqa	pouto, svazek
alyumini	hliník
amak	strýc
amaliyot	čin, jednání, děj, skutek, akce
amma	teta
ammo	ale, avšak
amniyat	bezpečnost, bezpečí
amudi	svislý
an'ana	tradice
an'anavi	tradiční
anbuh	hustý, tlustý, silný
andeša	myšlenka
andešai bad	zlá myšlenka
andešidan	myslet, mínit, přemýšlet
andoxtan	hodit, vrhat, střílet, střelit
andoz	daň
andoza	stupeň
anduh	smutek, stesk
angišt	uhlí
anglisi	anglický
angor	prostor, prostranství, plocha, areál
angur	hrozny
angušt	prst
anguštarin	prsten, kroužek
aniq	přesný
anor	granátové jablko
anvo	materiál
anjom	oblek, výroba
apa	sestra
apil	lípa
aqalliyat	menšina
aqibgoh	týl
aql	rozum
arabi	arabský
argon	argon
armani	arménský
aroba	auto
arof	očistec
arra	pila
arrapušt	páteř
artiš	armáda, vojsko
arus	snoubenka
arzan	proso
arzidan	stát, mít cenu
arziši miyona	střední hodnota
arzon	levný, laciný
asab	nerv
asalak	cukr
asar	stopa
asav	kobyla
asiri jangi	válečný zajatec
askari	voják, vojín
asl	základ
aslan	neboť, vskutku, opravdu
asli	prvotní
asorat	zajetí
asosan	hlavně
asosi	hlavní
asosnok	dostatečný
asp	kůň
asror	tajemství
asrori tabiat	tajemství přírody
ašk	slza
ašxos	lidé
avlod	potomstvo
avrang	trůn
avval	počátek, začátek
axmak	blbec, pitomec, idiot
ayb	chyba
aybdor	žaloba, obžaloba
aybdoršuda	obžalovaný
aybnoma	výrok, rozsudek
az	z, od
azob	utrpení
azot	dusík
ba	k, do, směrem k (vyjádření dativu)
babr	lev
bad	špatný, zlý
bahil	lakomý, skoupý
bahor	jaro
bahr	moře
baland šudan	rozmnožovat, zvětšovat, zvyšovat
bale	ano
balki	ale, avšak
bar	šířka
barf	sníh
barkašidan	vážit, zvážit
barobari	rovnost, shoda
baroi	pro, za
baroi či	proč, nač
baron onki	protože
barq	blesk, záblesk
barra	jehně, beránek
barvaqt	záhy, brzy, dříve
bastan	připojit, upevnit, svázat, přišít
baxšidan	prominout, odpustit
baxt	štěstí, blaho
baxtiyor	šťastný
baynulmilal	mezinárodní
be	bez
bed	vrba
begoh	večer
begunoh	nevinný
behtar	lepší
bel	rýč
belorusi	běloruský
bemor	nemocný
benamoud	nehezký, ošklivý
berilli	beryllium
beštar	lépe
beva	vdova
bezan	svobodný
bini	nos
birinj	rýže
bist	dvacet
bo	s
bobo	dědeček
bod	vítr
bodbon	plachta
bofanda	tkadlec
boftan	tkát
bokira	panna
bolqa	kladivo
bom	střecha
boq	zahrada
bor	váha, bor
boridan	pršet
boron	déšť
bosniyagi	bosenský
bozor	trh, bazar
bozsoz	přestavba
brom	brom
budan	být
bum	sova
buqa	býk
bur	křída
burdan	nést, přinést
buridan	stříhat, ostříhat
burj	věž
buron	bouře
busa	polibek
butparasti	pohanství
buvi	babička
buy	vůně, pach
buzurg	velký
čahor	čtyři
čahorum	čtvrtý
čakalak	les
čaman	louka
čana	sáně
čang	prach
čap	levý
čaridan	pást se
čarm	kůže
čaroq	lampa
čarx	kolo
čašm	oko
čašmak	oko
čatr	deštník
čexi	český
či	co, který, jenž
čiz	věc
čodar	závoj, čádor
čoh	studna
čor	čtyři
čorum	čtvrtý
čoy	čaj
čujagirak	jestřáb
čukur	hluboký, důkladný
čulok	kulhavý
čun	ale, avšak
čunki	neboť, protože, poněvadž
čupon	pastýř
čutka	kartáč
daftar	sešit
dah	deset
dahon	ústa
dahum	desátý, desetina
daiman	vždy, stále, pořád
dalel	důkaz
daqiqa	minuta
dar	v, dveře
dar osoištagi	v míru
dar zamoni	za (čas.), po dobu, v čase
darav	úroda, žeň, sklizeň
daraxt	strom
darbon	vrátný
darbor	palác
dard	bolest
daroz	dlouhý
dars	lekce
dast	ruka
dasta	držadlo, rukojeť
dasti čap	levá ruka
dasti rost	pravá ruka
davlat	stát, země
davor zanondan	otočit, obrátit, zatočit
deha	vesnice, ves
dehkon	sedlák, venkovan
der	pozdě
dev	netvor, obluda, stvůra, ďábel
devor	zeď, stěna
didan	vidět
digar	jiný, další
din	náboženství
diqqat	pozor
donistan	vědět, znát, umět
donišjuy	univerzita, vysoká škola
doru	lék
dorusoz	lékárník
doštan	mít
du	dva, dvě
duda	saze
dugona	přítelkyně
dukon	obchůdek
dungi	koš
dunyo	svět
dur	daleký, vzdálený
duraxšidan	lesknout se, třpytit se
duraxšon	lesk, třpyt
duredgar	truhlář
durud	nazdar, ahoj
duruq	lež
dust	přítel
dust doštan	milovat, mít rád
dusti	přátelství
dušanbe	pondělí
dušidan	dojit
dušman	nepřítel
duzd	zloděj
duzdidan	ukrást, odcizit
ehtimol	snad, možná
erdam	pomoc
ey	vyjádření vokativu
fared	výzva, volání
faromuš	opomenutí
faromuš kardan	opomenout
farošturuk	vlaštovka
farš	půda, země
farzand	dítě, syn
fasl	roční období, sezona
faxr kardan	chlubit se
fil	slon
fini	finský
firdavs	ráj
firistodan	poslat, odeslat, zaslat
forsi	perský
fosfor	fosfor
fransavi	francouzský
ftor	fluor
furešanada	obchodní, kupec, obchodník
furu burdan	polykat, hltat
furuš	prodej
furušanda	prodavač
furuxtan	prodávat, prodat
fužak	pijavice
gagauzi	gagauzský
gahvora	kolébka
gala	smečka, hejno, stádo
galli	gallium
ganda	zlý, špatný
gandum	pšenice
ganj	poklad
garavgon	rukojmí
gardan	krk, hrdlo
garm	horký, teplý, vřelý
garmiča	puchýř
gavazn	jelen
gavmija	ječné zrno
gazidan	kousnout, uštknout
gazna	kopřiva
gazvor	plátno, obraz
geli	helium
germani	germanium
gidrogen	vodík
gird	kulatý, okrouhlý
gireh	uzel
giristan	plakat, slzet
giyoh	rostlina, bylina
gov	kráva
guftan	říci, pravit, říkat
gum kardan	zmařit, ztratit, zahubit
gumruk	celnice, clo
gung	němý
gungišk	vrabec
gunoh	hřích
gunoh kardan	zhřešit
gunohkor	hříšný
gur	hrob
gurda	ledvina
gurg	vlk
gurm	suk
gurusna	hladový
gurxar	zebra
gusfand	beran
guš	ucho
gušna šudan	mít hlad, hladovět
gušt	maso
guzoštan	klást, položit, postavit
ha	ano
hafa	smutný, truchlivý
haft	sedm
hafta	týden
haftum	sedmý
hama	všechen, každý, všichni
hama čiz	všechno, vše
hamla	útok
haqiqat	skutečnost
harf	písmeno
harf zadan	mluvit
harguš	koktavý
harom	nečistý
hašt	osm
havo	vzduch, počasí
havopaymo	letadlo
hayot	život
hayvon	zvíře, živočich
hayz	menstruace
hazor	tisíc
hazorum	tisící
hec kas	nikdo, žádný
heč čiz	nic
hissiyot	pocity
holandi	holandský
hujum	útok
hujum kardan	útočit, udeřit, napadnout, zaútočit
iblis	ďábel, satan
ibtido	začátek, počátek
idiš	jidiš
iflok	špinavý
imon	víra
imruz	dnes
in	tento, tato, toto
indoneziyagi	indonéský
intizom	pořádek
injil	evangelium
injo	zde, tady
ioqut	rubín
iroda	vůle
ism	jméno
Iso	Ježíš
ispani	španělský
italiyovi	italský
Iyoloti Muttahida	Spojené státy
iz	stopa
jahidan	skákat, skočit
jahon	svět
jalol	sláva
jang	válka
jangidan	válčit
janub	jih
jar	úvoz, rokle, úžlabina
jav	oves
javdor	žito
javob	odpověď
javon	mladý
javoni	mládí
jevon	skříň
jinsi mardona	mužské pohlaví
jinsi zanona	ženské pohlaví
jiray šepal gel	hlína, jíl
jiyan	synovec
jodugar	kouzelník, čaroděj
jon	duše
joponi	japonský
joq	čelist
jorub	koště, smeták
jovidan	žvýkat
juft	pár, dvojice, sudý
jumla	věta, fráze
kabud	modrý
kabutar	holub
kahrahmon	hrdina
kahva	káva
kalagi	cín
kalamuš	krysa
kali	draslík
kalima	slovo
kalom	slovo
kalpesa	ještěrka
kam	trochu
kambaqal	chudý, ubohý
kamon	oblouk
kandu	úl
kanot	křídlo, peruť
kar	hluchý
karbon	uhlík
kas	osoba
kast	msta, pomsta
kašok	chudý, ubohý
kataloni	katalánský
kay	kdy
každum	štír
kelin	snacha
ki	kdo
kirgizi	kyrgyzský
kirm	červ
kirmin	červivý
kišlok	vesnice
kišvar	země, stát
kitob	kniha
kobalt	kobalt
koh	sláma
koj	jedle
kon	důl
koqazam	papír
kor	práce
kor kardan	pracovat
koreyagi	korejský
korgar	dělník
koridan	sít
kormand	zaměstnanec, pracovník
koštan	zasadit
kripton	krypton
kubidan	mlít
kuča	město
kudak	dítě
kuh	hora
kuhna	starý
kujo	kde
kul	jezero
kulang	volavka
kuloh	čepice
kunj	úhel
kupruk	most
kur	slepý, nevidomý
kurta	šaty
kušiš	snaha, úsilí, námaha
kušodan	otevřít
kuštan	zabít
kuya	mol
lab	ret
lal	safír
langar	kotva
langidan	kulhat
larg	jilm
larzidan	třást se, chvět se
lekin	ale, avšak
liti	lithium
litvagi	litevský
loy	bláto, bahno
lozim	nutný, potřebný, nezbytný
lubyo	fazole
luč	nahý, holý
luxtak	loutka, panenka
magni	hořčík
makedoni	makedonský
makidan	sát, cucat
maktab	škola
maktub	dopis, list
malakut	království
malaziyagi	malajský
malla	plavovlasý
mamot	smrt
man	já
mangan	mangan
mano	smysl, význam
manzil	byt
maqz	mozek
mard	muž, manžel
mardona	mužský
mardum	lid
marg	smrt
markaz	střed, centrum
marvorid	perla
Maseh	Mesiáš, Kristus
mast	opilý
matematika	matematika
matn	text
mato	tkanina, látka
Matto	Matouš
mavj	vlna
may	víno
maymun	opice
meš	ovce
metin	krumpáč
meva	ovoce
mexi pečdor	šroub
mexnatdust	pracovník
mezak	moč
mezidan	močit
milal	národ
minatdor	uznalý, vděčný
minqor	zobák
miranda	smrtelný
mis	měď
mîšyak	arzen
miyona	střed, centrum
miz	stůl
mo	my
modar	matka
modyon	kobyla
moh	měsíc
mohi	ryba
mol	zboží
mor	had
mordaxur	sup
muallim	profesor
muhabbat	láska
muhim	důležitý
muqaddas	svatý, posvěcený
murč	pepř
murda	mrtvý, zesnulý
murdagi	mrtvý, zesnulý
murdan	zemřít, skonat, umřít
murud	hruška
musofir	cestovatel, cestující
muš	myš
mušt	pěst
muzd	mzda
nafar	osoba, člověk
najot	spása
namak	sůl
namoz	modlitba
namoz xondan	modlit se, prosit
namudan	zdát se, jevit se
narm	měkký
narx	cena
nasim	safír
nask	čočka
natri	sodík
nav	nový
naxud	hrách
naxustvazir	premiér, předseda vlády
nay	rákos, třtina
nayza	kopí, oštěp
nazdik	blízko
neon	neon
nikel’	nikl
nikoh	manželství
nim	půl, polovina
nisf	polovina
nišasta	položený, umístěný
nišon	znaménko
nišon dodan	ukázat, projevit
ništyak	jeskyně
nok	hruška
nom	jméno
nomdor	zvaný, jmenovaný, řečený
nomidan	pojmenovat, jmenovat
non	chléb
norvegi	norský
noxun	nehet
nuh	devět
nuhum	devátý
nukra	stříbro
nur	světlo
nušidan	pít
nušok	nápoj
ob	voda
odam	člověk
odamiyon	lidé
odamon	lidé
oddiy	prostý, jednoduchý
ofaridan	tvořit, stvořit
oftob	slunce
oftobparast	slunečnice
ohan	železo
ohu	laň
oilador	ženatý, vdaná
oksigen	kyslík
olaš	buk
olim	vědec, učenec
olmoni	německý
olu	švestka
omad	příchod
omadan	přijít, přicházet
omextan	míchat, smísit
omin	amen
omuxtan	učit, vyučovat
omuzgor	učitel
on	ten, ta, to, tamten, tamta, tamto
onho	oni, ony, ona, ti, ty, ta
orinj	loket
orom	klidný, tichý, pokojný
oromi	ticho, klid
orzu	přání
osiyob	mlýn
osmon	nebe
osoištagi	mír, pokoj
ošiq	láska
ošxona	kuchyně
ošyona	hnízdo
otaš	oheň
ovardan	přinášet, přinést
ovexta	pověšený, oběšený
ovextan	pověsit, viset, oběsit
ovoz	hlas
ozari	ázerbájdžánský
ozaxm	bradavice
ozmoiš	pokušení
ozmudan	testovat
ozodona	volnost, svoboda
padar	otec
pakana	trpaslík
palang	tygr
panj	pět
par	pero
paranda	pták
parčam	vlajka, prapor
pardoxtan	platit
paridan	letět, létat
partoftan	zvracet
paša	moucha
pašm	vlna
paxta	bavlna
peš	předek, přední část
Petrus	Petr
pezešk	lékař
pilk	víčko
pir	starý
piramard	stařec
pirduxtar	stará panna
piston	vemeno
piyodagard	chodec, pěší
piyola	šálek, hrnek
piyoz	cibule, pórek
po	noha
pok	vlastní, příslušný
polyaki	polský
portugali	portugalský
pukkašak	vývrtka
pul	most, peníze
pur	plný
purmasoma	buněčný, buničitý
pursidan	ptát se, dotazovat se
pursiš	dotaz, otázka
pust	kůže
pustin	kožich
pušok	oblek
pušt	záda, hřbet
puxtan	vařit, péci
qabila	kmen, národ
qabul kardan	přijmout
qadam	krok
qafas	klec
qarb	západ
qasr	palác
qašqaldoq	jezevec
qeg kas	nikdo
qonun	zákon, právo
qoz	husa
qu	labuť
quk	ropucha
qulla	vrch, vrchol
qulom	nevolník
qulomi	nevolnictví, poroba
qurridan	výt, řvát
quvvat	moc
raftan	jít
rag	žíla
rahmat	milost
raksidan	tančit
ran	stehno, kýta
randa	hoblík
raqam	číslice
rasida	dospělý, zralý
rasidagi	dospělost, zralost
rasidan	dospět, dozrát
ravqan	máslo
ravšan	světelný
ravšani	světlo
raxna	díra
reg	písek
reša	kořen
revoj	rebarbora
rod	řeka
roh	cesta
rohbar	vůdce, průvodce
rost	pravda, pravý, pravdivý
rosti	pravda
rozak	chmel
rubidi	rubidium
ruboh	liška
ruftan	mést, zametat
ruh	duch, zinek
ruhsora	tvář, líce
rujat	seznam, listina
rumini	rumunský
rumolča	kapesník
ruqat	seznam, listina, soupis
rusi	ruský
ruxsat	prázdniny, dovolená
ruy	obličej, líc
ruz	den
sabz	zelený, zeleň
sad	sto
sadbarg	růže
sado	hlas
sadum	stý
sadum bor	stokrát
sadyak	setina
safar	cestování, jízda, cesta
safed	bílý
safedor	topol
sala	turban
salab	orchidej
salomati	zdraví
sang	kámen
sangpušt	želva
sanovbar	borovice, sosna
sar	hlava
sarkaš	tvrdohlavý, umíněný
savgang	přísaha
savsan	lilie
savsor	kuna
savvum	třetí
sayora	planeta
se	tři
seb	jablko
selen	selen
ser	nasycený, sytý
serbi	srbský
seyum	třetí
sihr	tajemství
siliciy	křemík
siloh	zbraň
simob	rtuť
sin	věk
sina	hruď, prsa
sinf	třída
sipar	štít
sipas	potom, pak
sipor	pluh
siposguzor	uznalý, vděčný
sipurz	slezina
sir	česnek
sirištan	válet, hníst
sirko	ocet
sitod	štáb
sitora	hvězda
sitorazor	hvězdný
siyoh	černý, čerň
siyosat	politika
skandi	skandium
slovaki	slovenský
sloveni	slovinský
soat	hodinky
sol	rok
sola	rok
solnoma	kalendář
solonai	roční, výroční
soya	stín
sozanda	hudebník, muzikant
sozgor	zdravý
soziš	soulad, souhlas
sozmon	organizace
Sozmoni Milali Muttaxid	Organizace spojených národů
sudmand	výhodný
suiqasd	vražda
sulfur	síra
sulola	dynastie
suol	otázka
suporidan	rozkázat, velet, přikázat, poručit
suqut	ticho, mlčení
surat	obraz, podoba
surb	olovo
surfa	kašel
surox	díra
surud	zpěv
surudan	zpívat
surx	červený, červeň
sust	pomalý, liknavý
sutun	sloup
suxtor	popálenina
suzan	jehla
suzon	horký, vřelý, palčivý
ša'n	sláva
šab	noc
šabona	noc
šabparak	noční můra
šadid	silný, mohutný
šafak	úsvit, svítání
šaffof	průhledný, průsvitný
šaftolu	broskev
šahodat	svědectví
šahr	město
šahri buzurg	velkoměsto
šahrvand	občan
šahrvandi	občanský, civilní
šak	pochybnost, nejistota
šakar	cukr
šalvor	kalhoty
šam	svíčka, svíce
šamol	vítr
šamšer	meč
šaraf	sláva
šarayon	tepna
šarbat	šťáva, džus
šariki	obyčejný, obecný, všední
šarm	hanba, ostuda
šarmgin	nesmělý, plachý, bázlivý
šarmin	stydlivý, ostýchavý
šarnoma	dohoda, úmluva
šarob	šťáva, džus
šarora	jiskra
šarq	východ
šart	sázka
šaš	šest
šašum	šestý
šašyak	šestina
šavhar	manžel, choť
šavq	zájem
šaxse	člověk, bytost
šelon	jídlo, chod
šer	lev
ševa	nářečí, dialekt
šift	strop
šikam	břicho
šikanja	mučení, muka
šikast	porážka
šikasta	rozbitý, zlomený
šikastan	lámat
šikof	díra
šikor	hon, lov
šikorči	lovec, myslivec
šikoridan	lovit, honit
šimol	sever
šino	plavání
šinondan	posadit, usadit
šinos	známý
šinoxtan	znát
šior	brázda
šir	mléko
širgarm	teplý, horký
širin	sladký, lahodný
širkat	úřad, kancelář, společnost
šistan	položit, umístit, sedět
šiša	láhev, sklo
šiyar	brázda
šod	veselý, radostný
šogird	žák
šoh	král
šohgavazn	los
šona	hřeben
šubušk	veš
šudan	stát se
šug	bajka
šuh	veselý, radostný
šuhratmand	známý
šuhratnok	známý
šujo'	odvážný, statečný
šujoat	odvaha, statečnost
šukufa	květina, květ
šula	plamen
šumo	vy
šumor	jiskra
šumtol	jasan
šumur	počet, výčet
šumurdan	počítat
šung	jasan
šunidan	slyšet
šuo	paprsek
šuql	povolání, zaměstnání
šuravi	svazový
šurbo	polévka
šuriš	povstání, pozdvižení
šuro	rada
šurrut	kapalina, tekutina
šurtan	štika
šustan	mýt, umývat
šuš	plíce
šutur	velbloud
šuur	vědomí, svědomí
šuxrat	sláva
švedi	švédský
ta'in	setkání
tab	horečka
tabar	sekera
tabdil	změna
tabiat	příroda
tadovi	uzdravení, vyléčení
tafsoniš	topení
tagarg	kroupy, krupobití
tahayur	údiv, úžas, ohromení
tahlil	rozbor
tajriba	zkušenost
takondan	třást, třepat, otřásat
takror	opakování
talab	žádost, prosba
talabidan	přát si, toužit
tamili	tamilský
taqo	strýc
tarjuman	překladatel, tlumočník
taroš	břitva
tarošidan	holit
tars	strach, obava
tarsidan	bát se, mít strach, obávat se
tarsončak	bojácný, zbabělý, bázlivý, zbabělec
tasma	pás, opasek, pásek
tavallud	narození, zrození
tavonistan	moci, smět
tavr	způsob
taxt	trůn
taxta	prkno, lávka
tayi	thajský
tayloq	tele
tayora	připravený, hotový
tešuk	díra
tez	ostrý, rychlý, prudký, rychle, honem
tillo	zlato
tin	stříbro
tir	osa
tiramoh	podzim
tirandoz	střelec
titan	titan
tobiston	léto
torik	tmavý, temný
tortanak	pavouk
totori	tatarský
tožik	tádžický
tu	ty
tuda	hromada, kupa
tuf	slina
tuhfa	dar
tuman	mlha
tund	hořký
turki	turecký
tus	bříza
tuxm	vejce
u	on
ukob	orel
ukraini	ukrajinský
ustuxon	kost
utok	kus
uzbek	uzbecký
va	a
vagon	vagon, vůz
vakte	když
vakte ki	mezitímco
vale	ale, avšak
vanadi	vanad
vaqt	čas
vaqte	když
vay	on, ona, ono
vazidan	vanout, foukat
vaznin	těžký
vengeri	maďarský
vetnami	vietnamský
vitrina	výloha, vitrína
xabar	novinka, zpráva
xam	také, rovněž, též
xamir	pasta
xamsoya	soused, bližní
xanda	smích
xandidan	smát se
xar	osel
xarf	písmo
xargiš	králík
xarob	hubený
xarorat	teplota
xatarnok	nebezpečí
xazanda	plaz
xedzvakt	kdy, vůbec někdy
xele	velmi
xeš	příbuzný
xirad	moudrost
xirs	medvěd
xišt	cihla
xizmat	služba
xlor	chlor
xob	spánek
xohar	sestra
xohiš	vůle
xok	půda, země
xokistar	popel
xoksor	prach
xomušak	komár
xona	dům
xondan	číst
xonum	paní, dáma
xorvati	chorvatský
xostan	chtít
xrom	chrom
xub	dobrý
Xudo	Bůh
Xudovand	Pán, Hospodin
xuk	vepř, prase
xun	krev
xurok	potrava, strava, pokrm
xuronidan	živit, krmit
xursandi	radost
xusur	tchán
xušbaxtona	naštěstí, šťastně
xušk	suchý
yagonagi	jednota
yak	jeden, jedna, jedno
yakčand	několik
yakum	první
yaroq	zbraň
yaxdon	lednička, lednice
yo	nebo
yoftan	nalézt, objevit, shledat
yordam dodan	pomáhat
yordam kardan	pomáhat
yos	šeřík
Yuhanno	Jan
yunoni	řecký
zabon	jazyk
zabonšinos	jazykovědec, lingvista
zabonšinosi	lingvistika, jazykověda
zahr	jed
zamin	země
zamiston	zima
zamon	čas, doba
zamoni guzašta	čas minulý
zamoni oyanda	čas budoucí
zanbur	vosa
zandor	ženich
zang	rez
zarguš	králík
zaxm	zranění, rána
zaxmxurda	raněný, poraněný, zraněný
zebogi	krása
zeboyand	nádherný
zero	neboť
zinda	živý, čilý
zindagi	život
zindagi kardan	žít
zistan	žít
ziyod	rozmnožení, rozšíření, zvětšení
zoqnul	krumpáč
zudzud	často